NO ./main.c
EA ./main.c
SO ./main.c
WE ./main.c
C 225,25,010




					F 220,100,25





        1111111111111111111111111111
        10000000001   10000000000001
        10110000011111100000000001111
        1001000000000000000000001
11111111101100N001110000000000001
10000000001100000111011111111111
11110111111111011100000010001
11110111111111011101010010001
11111111111111111111111111111
