F 220,100,25
NO ./main.c
EA ./main.c
SO ./main.c
WE ./main.c
C 225,25,010





        1111111111111111111111111111
        10000000001   10000000000001
        10110000011111100000000001111
        1001000000100000000000001
111111111011000001110000000000001
10000000001100000111011111111111
11110111111111011100000010001
11110111111111011101010010001
11111111111111111111111111111



11111111111111111111111111111
11000000110101011100000010001
10010000000000001100000010001
100010000000000001101010010001
11000001110101011111011110N0111                          11111111
11110111 1110101 101111010001                            10000001
11111111 1111111 111111111111                            11111111
