1111
1111
11111
11111
11111


















andyh





